1111111111111111111
1100000000000000011
101000000000000T001
1010000000T00000001
100000T000000000011
1P00C000000000000E1
1111111111111111111