111111111111111111111111
100000000C00000C000000E1
10000T0T000T0T000T0T0001
1000T000T0T000T0T000T001
1P1T00C00000C00000C00T01
101111111111111111111111
100000000C00000C000000E1
10000T0T000T0T000T0T0001
1000T000T0T000T0T000T001
101T00C00000C00000C00T01
100000000C00000C000000E1
10000T0T000T0T000T0T0001
1000T000T0T000T0T000T001
101T00C00000C00000C00T01
111111111111111111111111