1111111111111111111111111111111111
1E00000000001T0C00000C0000000000T1
101001010010T0T001010010010001T101
1010010010101010001001000000T10101
1P0000000C00C0000000T0000100000001
1111111111111111111111111111111111