111111111111111111111111111111
1P00000C0001000000100010000001
1000000000000000000010001T00E1
111111111111111111111111000111
111111111111110111110000011111
10000000000000000T000111000001
100111111110110111111111111111
10111111111C110111111111111111
10010000000001000000000T0000C1
111101111111111111111111011111
100000000000000000T00000000001
111111111111111011111111111111
1000000000000000000000000000C1
101111111111111111111111111111
1000011111111000C001000C111111
1010C1111C101010000101100000E1
101000000000101000010110111111
100011111111101111110110111111
1000000000000C00000001100000E1
111111111111111111111111111111