111111111111111
1P0000000000001
1000000000T0001
10000C000000001
1000001000E0001
100000T00000001
100000100000001
111111111111111