111111111111111111111111111
1P000000000C0000000T00T00E1
101111011110111101000111101
101000010010100101000100101
10100T011110111101000111101
101000010010101001000100101
101111010010100101110100101
100000000000CCCC000T00T0001
111111111111111111111111111