NO ./textures/42.png
SO ./textures/42.txt.1.png
WE ./textures/42.txt.4.png
EA ./textures/42.txt.2.png

DOOR ./textures/txt_stone/Puerta1.png
SPRITE ./textures/txt_stone/dhalsim.png

F 118,118,118
C 39,41,39

            1111111111111111111111111111
            1000000000000000000000000001
            1000000000U00000000000000001
            1000000000000000000000000001
            1000011111110000111111100001  111111111111111111
            100001     100001     100001  100000000100000001
111111      100001     100001     100001  100000000100000001
100001      100001     100001     100001  100000000100000001
111101111111100001     100001     10000111101111111111111101
100000000000000001     100001     10000000000000000000000001
111111111111100001     100001     10000111111111111111111111
            100001     100001     100001
            100001     100001     100001
            100001     100001     100001
            100001     100001     100001
            100001     100001     100001
            100001     100001     100001
            100001     100001     101111
            100001     100001     100001
            100001     100001     101001 
            100001     100001     10111111
            100011111111100011111110000001
            100000000000000000000000000001 
            111110000001111111111111111111
               1110N00111111
                 111111