NO      textures/txt_stone/pared_piedra_2.png
SO      textures/txt_stone/pared_piedra.png
WE      textures/txt_stone/Paredbloquespiedra.png
EA  textures/txt_stone/paredbloquespiedra2.png
F          79,88,76

DOOR        ./textures/txt_stone/WoodDoor.png
SPRITE      ./textures/txt_stone/dhalsim.png
 
C 0,216,255


              111111111111111111111111111
              100000000000000000000000001
              101111111111111111111111101
              101                     101
111111111111111D11111111              101   
110U00000000000000000001              101
100U00000000000000000001111111111111111D1111
1UUU0000000000000000000110000000000D00000001
1000000000000000U000000110111111110111111101
100000000000000000000001101      101     101
111111000000000000000001101      101     101    
111111000000000000000001101      101     101
1  111000011D1100000000D001      101     101    
1111U0000100001000000001111      101     101
100000001000000100000001       111D111111101
10000011000000001100001        1000000001101
100000100000000000100001       1000000001101
100000111100001111000001       100000000D001
10000000001001000000111111111111000000001111
1000000000100D000000D0000000000D000000001
10000000001111100000111111111111000000001111111
100U00000001100000000001       100000000D000001
100000000000000000000001       100U000001111101
1000000000000000N0000001       1111111111   101
100001111110000000000001                    101
100001    10000000U00011                    101
100001111111111111111111                    101
110000000000000000000001                    101
 1111D11111111111111111                     101
    101                                     101
    101                                     101
    101                                     101
    1011111111111111111111111111111111111111101
    10D0000000000000000000000000000000000000001
    1011111111111111111111111111111111111111111
    101
    1D111
    10001
    11111