1111111111111111111
1100000000000000011
1010000000000000001
1010000000000000001
1000000000000000011
1P00C000000000000E1
1111111111111111111