11111111111111111111111111111111
10000000000000000000000C00000001
10011001100111111011110011111111
100110011001111110111100111E0011
1001100110000C000010010011100001
10011001100000000010010011100001
100000000000000P0000000000000001
11111111111111111111111111111111