111111111111111
1P0000000000001
100000000000001
10000C000000001
1000000000E0001
100000000000001
100000000000001
111111111111111